0 0 0 0 1 0 0 0 0 0 1 0 0 0 0
0 0 0 0 0 3 2 3 2 3 0 0 0 0 0
2 0 0 0 0 0 4 0 0 0 0 0 0 0 2
2 0 1 0 0 1 0 0 0 0 14 0 0 0 2
0 0 0 0 0 0 0 0 0 0 0 0 0 0 0
0 1 0 1 0 3 0 0 0 0 0 0 0 1 0
0 0 0 12 0 0 0 4 0 13 0 0 0 0 0
2 0 1 0 0 1 0 0 0 0 0 0 0 0 2
2 0 0 0 0 0 0 0 0 0 0 0 0 0 2
0 0 0 0 3 3 0 15 14 4 0 0 0 0 0