0 0 0 0 0 0 4 3 4 4 4 4 4 6 0
0 0 0 0 1 0 0 0 0 1 0 1 0 3 2
0 0 1 1 0 0 0 0 0 0 0 3 0 0 0
0 1 0 0 0 0 0 0 1 1 1 1 0 1 2
0 1 0 3 0 1 1 0 3 0 0 0 0 1 0
0 1 0 1 2 0 0 1 0 3 0 0 1 0 0
2 1 0 1 2 1 0 0 1 1 1 1 0 4 0
2 8 2 8 2 8 0 3 3 3 3 0 0 0 0
0 1 0 1 0 1 1 1 1 0 0 0 0 0 0
0 0 0 0 0 0 0 15 1 0 3 3 3 3 0