0 0 0 0 0 1 6 6 6 0 0 3 6 0 0
2 3 3 3 3 4 3 3 4 0 0 0 3 0 0
0 1 1 0 0 0 11 0 12 0 0 1 0 0 0
9 0 1 0 0 1 1 0 1 1 1 0 0 0 0
0 0 1 1 1 0 12 0 11 0 1 0 0 0 0
0 1 0 12 0 0 1 0 1 0 1 1 9 1 1
9 0 9 0 10 0 1 0 1 0 0 3 3 3 0
0 12 0 11 0 10 1 9 1 0 0 0 0 6 0
11 0 9 0 10 0 1 0 1 0 0 3 4 3 0
0 12 0 12 0 1 1 15 1 0 0 0 0 0 1