0 0 0 0 0 0 13 13 13 0 0 0 0 0 0
0 0 0 0 0 0 0 0 1 1 1 1 0 0 0
0 0 0 0 0 1 1 1 0 0 0 12 0 0 0
1 1 1 1 1 0 0 0 0 0 1 1 0 0 0
0 0 0 0 0 0 1 1 1 1 0 0 1 0 1
0 0 1 0 0 0 0 3 0 0 0 0 12 0 0
1 0 1 1 1 1 1 1 0 1 0 1 0 0 0
0 0 0 0 0 4 0 12 0 1 0 1 0 0 0
0 0 0 0 0 0 1 1 0 0 0 0 0 3 0
0 0 0 0 0 0 0 15 1 0 0 1 1 5 1