0 4 0 0 0 3 3 6 3 3 6 3 3 6 3
0 4 0 0 1 1 1 2 1 0 13 0 0 13 0
0 1 1 1 0 0 1 2 1 0 14 0 0 14 0
9 0 0 1 1 1 0 2 1 0 14 0 0 14 0
0 2 2 0 1 0 0 13 1 1 1 4 0 1 0
1 14 14 9 1 0 0 14 0 0 1 0 1 1 1
0 2 2 0 1 0 0 14 0 0 1 0 0 1 0
1 1 0 1 1 1 0 1 0 1 1 0 0 0 0
0 0 0 0 0 0 0 0 0 0 0 0 0 0 0
0 0 0 0 1 0 0 15 0 0 1 0 0 0 0