1 0 0 1 0 0 1 0 0 0 0 1 0 0 0
0 0 2 1 0 1 0 0 0 2 2 0 0 1 0
0 2 4 1 1 1 1 1 1 4 4 1 1 0 0
0 0 2 0 0 3 0 0 0 2 0 0 0 1 0
0 1 0 0 0 0 0 1 1 4 1 0 1 0 0
0 0 1 1 1 1 0 0 1 2 0 0 3 3 0
0 1 0 0 0 0 1 0 1 2 1 0 3 3 0
0 0 1 4 4 0 1 0 0 0 7 2 1 0 0
0 0 0 2 2 0 0 1 0 0 1 0 4 0 0
0 0 1 0 0 1 0 15 1 0 1 0 4 0 1