0 0 0 1 0 0 6 0 0 0 0 0 0 0 0
0 0 0 3 3 3 6 3 3 3 3 3 3 2 8
0 0 0 0 0 0 3 0 0 0 0 0 1 4 0
0 0 0 0 0 0 0 0 0 0 0 0 0 2 0
0 0 0 0 0 0 1 0 0 0 0 0 0 2 0
7 3 3 3 2 1 1 1 1 1 1 1 1 2 1
1 1 1 1 0 1 0 1 0 0 0 1 1 2 0
0 0 0 0 0 3 0 0 0 0 0 0 1 2 0
0 0 0 0 0 1 1 1 1 1 1 2 4 3 0
0 0 0 0 0 15 0 0 1 0 0 0 0 5 0