0 0 0 0 0 0 0 0 0 0 0 0 0 0 0
0 0 0 0 9 0 10 0 11 0 12 0 0 0 0
0 0 0 0 0 0 0 0 0 0 0 0 0 0 0
0 0 0 0 0 0 0 0 0 0 0 0 0 0 0
0 1 0 0 0 0 0 0 0 1 0 1 1 1 0
0 1 0 0 1 0 1 0 0 1 0 0 0 1 0
0 1 0 0 1 0 1 0 0 1 0 1 1 1 0
0 1 1 1 0 1 0 0 0 1 0 1 0 0 0
0 0 0 0 0 0 0 0 0 0 0 1 1 1 0
0 0 0 0 0 0 0 15 11 0 0 0 0 0 0